順位,名前,童貞得票,非童貞得票,総得票,童貞/非童貞
1,的場梨沙,7,1,8,7
2,大原みちる,6,1,7,6
3,村上巴,5,1,6,5
3,十時愛梨,5,1,6,5
5,道明寺歌鈴,8,2,10,4
5,赤城みりあ,12,3,15,4
5,財前時子,4,1,5,4
5,西園寺琴歌,4,1,5,4
5,池袋晶葉,4,1,5,4
5,佐城雪美,12,3,15,4
11,神崎蘭子,22,6,28,3.666666667
12,ライラ,7,2,9,3.5
13,遊佐こずえ,6,2,8,3
13,桃井あずき,3,1,4,3
13,工藤忍,6,2,8,3
16,高森藍子,37,13,50,2.846153846
17,上条春菜,11,4,15,2.75
18,早坂美玲,8,3,11,2.666666667
19,菊地真,5,2,7,2.5
19,小関麗奈,5,2,7,2.5
21,白菊ほたる,9,4,13,2.25
22,龍崎薫,4,2,6,2
22,黒川千秋,2,1,3,2
22,関裕美,10,5,15,2
22,大沼くるみ,2,1,3,2
22,城ヶ崎莉嘉,4,2,6,2
22,並木芽衣子,6,3,9,2
28,森久保乃々,21,11,32,1.909090909
29,姫川友紀,11,6,17,1.833333333
30,渋谷凛,31,17,48,1.823529412
31,日野茜,9,5,14,1.8
32,相葉夕美,14,8,22,1.75
32,喜多日菜子,7,4,11,1.75
32,今井加奈,7,4,11,1.75
35,鷺沢文香,31,18,49,1.722222222
36,新田美波,24,14,38,1.714285714
37,椎名法子,5,3,8,1.666666667
38,結城晴,8,5,13,1.6
39,緒方智絵里,27,17,44,1.588235294
40,荒木比奈,11,7,18,1.571428571
41,多田李衣菜,23,15,38,1.533333333
42,海老原菜帆,6,4,10,1.5
42,南条光,6,4,10,1.5
42,クラリス,3,2,5,1.5
45,二宮飛鳥,22,15,37,1.466666667
46,星輝子,16,11,27,1.454545455
46,北条加蓮,32,22,54,1.454545455
48,櫻井桃華,10,7,17,1.428571429
49,小日向美穂,28,20,48,1.4
50,本田未央,19,14,33,1.357142857
50,前川みく,19,14,33,1.357142857
52,浜口あやめ,4,3,7,1.333333333
52,大石泉,8,6,14,1.333333333
52,双葉杏,20,15,35,1.333333333
52,依田芳乃,12,9,21,1.333333333
56,島村卯月,18,14,32,1.285714286
57,高峯のあ,5,4,9,1.25
58,水本ゆかり,12,10,22,1.2
58,五十嵐響子,12,10,22,1.2
60,アナスタシア,17,15,32,1.133333333
61,川島瑞樹,9,8,17,1.125
61,佐々木千枝,9,8,17,1.125
61,三村かな子,9,8,17,1.125
64,高垣楓,28,25,53,1.12
65,一ノ瀬志希,25,23,48,1.086956522
66,諸星きらり,12,12,24,1
66,西島櫂,1,1,2,1
66,藤原肇,10,10,20,1
66,萩原雪歩,2,2,4,1
66,相川千夏,1,1,2,1
66,片桐早苗,3,3,6,1
66,横山千佳,1,1,2,1
66,東郷あい,4,4,8,1
66,日下部若葉,2,2,4,1
66,我那覇響,2,2,4,1
66,宮本フレデリカ,16,16,32,1
66,古澤頼子,1,1,2,1
66,原田美世,1,1,2,1
66,兵藤レナ,1,1,2,1
66,三浦あずさ,1,1,2,1
66,イヴ・サンタクロース,3,3,6,1
82,神谷奈緒,25,26,51,0.961538462
83,安部菜々,19,20,39,0.95
84,輿水幸子,16,17,33,0.941176471
85,塩見周子,13,14,27,0.928571429
86,乙倉悠貴,9,10,19,0.9
87,速水奏,17,19,36,0.894736842
88,喜多見柚,7,8,15,0.875
89,佐藤心,13,16,29,0.8125
90,大槻唯,11,14,25,0.785714286
91,鷹富士茄子,10,13,23,0.769230769
92,藤本里奈,3,4,7,0.75
92,橘ありす,12,16,28,0.75
92,堀裕子,6,8,14,0.75
95,佐久間まゆ,28,39,67,0.717948718
96,高槻やよい,2,3,5,0.666666667
96,白坂小梅,14,21,35,0.666666667
96,松尾千鶴,2,3,5,0.666666667
96,市原仁奈,2,3,5,0.666666667
96,天海春香,2,3,5,0.666666667
96,城ヶ崎美嘉,8,12,20,0.666666667
96,四条貴音,2,3,5,0.666666667
96,仙崎恵磨,2,3,5,0.666666667
104,三船美優,11,17,28,0.647058824
105,小早川紗枝,8,13,21,0.615384615
106,中野有香,3,5,8,0.6
107,高橋礼子,1,2,3,0.5
107,藤居朋,1,2,3,0.5
107,綾瀬穂乃香,1,2,3,0.5
107,水木聖來,2,4,6,0.5
107,桐生つかさ,1,2,3,0.5
107,松永涼,1,2,3,0.5
107,松本沙理奈,1,2,3,0.5
107,村松さくら,1,2,3,0.5
107,服部瞳子,1,2,3,0.5
107,星井美希,2,4,6,0.5
107,斉藤洋子,1,2,3,0.5
107,如月千早,1,2,3,0.5
107,及川雫,2,4,6,0.5
107,ナターリア,2,4,6,0.5
121,八神マキノ,1,3,4,0.333333333
122,木村夏樹,2,8,10,0.25
122,奥山沙織,1,4,5,0.25
124,向井拓海,1,6,7,0.166666667
125,脇山珠美,1,7,8,0.142857143
126,和久井留美,1,9,10,0.111111111
127,首藤葵,2,0,2,0
127,難波笑美,0,1,1,0
127,間中美里,0,0,0,0
127,長富蓮実,2,0,2,0
127,野々村そら,0,0,0,0
127,赤西瑛梨華,0,0,0,0
127,西川保奈美,0,0,0,0
127,衛藤美紗希,0,0,0,0
127,若林智香,0,1,1,0
127,篠原礼,0,0,0,0
127,秋月律子,0,2,2,0
127,福山舞,1,0,1,0
127,矢口美羽,2,0,2,0
127,真鍋いつき,0,2,2,0
127,相馬夏美,0,0,0,0
127,相原雪乃,1,0,1,0
127,瀬名詩織,0,0,0,0
127,涼宮星花,1,0,1,0
127,浜川愛結奈,0,0,0,0
127,浅野風香,0,0,0,0
127,浅利七海,2,0,2,0
127,沢田麻理菜,0,0,0,0
127,江上椿,1,0,1,0
127,水野翠,0,0,0,0
127,水瀬伊織,2,0,2,0
127,氏家むつみ,0,1,1,0
127,槙原志保,0,0,0,0
127,榊原里美,0,0,0,0
127,楊菲菲,0,0,0,0
127,棟方愛海,4,0,4,0
127,梅木音葉,4,0,4,0
127,桐野アヤ,0,0,0,0
127,栗原ネネ,0,2,2,0
127,柳瀬美由紀,0,0,0,0
127,柳清良,0,0,0,0
127,柊志乃,0,1,1,0
127,松山久美子,2,0,2,0
127,松原早耶,0,0,0,0
127,杉坂海,0,0,0,0
127,木場真奈美,1,0,1,0
127,望月聖,0,1,1,0
127,有浦柑奈,4,0,4,0
127,月宮雅,0,1,1,0
127,持田亜里沙,0,1,1,0
127,成宮由愛,2,0,2,0
127,愛野渚,0,1,1,0
127,岸部彩華,0,0,0,0
127,岡崎泰葉,3,0,3,0
127,小松伊吹,0,0,0,0
127,小室千奈美,0,0,0,0
127,安斎都,1,0,1,0
127,太田優,0,0,0,0
127,大西由里子,0,0,0,0
127,大和亜季,0,3,3,0
127,土屋亜子,2,0,2,0
127,吉岡沙紀,1,0,1,0
127,古賀小春,1,0,1,0
127,双海真美,0,1,1,0
127,双海亜美,0,0,0,0
127,北川真尋,0,1,1,0
127,冴島清美,1,0,1,0
127,伊集院惠,0,0,0,0
127,井村雪菜,0,0,0,0
127,丹羽仁美,2,0,2,0
127,上田鈴帆,0,0,0,0
127,三好紗南,3,0,3,0
127,ルーキートレーナー,1,0,1,0
127,メアリー・コクラン,0,2,2,0
127,マスタートレーナー,0,0,0,0
127,ベテラントレーナー,0,0,0,0
127,ヘレン,0,1,1,0
127,トレーナー,0,0,0,0
127,ケイト,0,1,1,0
127,キャシー・グラハム,0,0,0,0