順位,名前,童貞得票,非童貞得票,総得票,童貞/非童貞
1,佐久間まゆ,28,39,67,0.717948718
2,北条加蓮,32,22,54,1.454545455
3,高垣楓,28,25,53,1.12
4,神谷奈緒,25,26,51,0.961538462
5,高森藍子,37,13,50,2.846153846
6,鷺沢文香,31,18,49,1.722222222
7,渋谷凛,31,17,48,1.823529412
7,小日向美穂,28,20,48,1.4
7,一ノ瀬志希,25,23,48,1.086956522
10,緒方智絵里,27,17,44,1.588235294
11,安部菜々,19,20,39,0.95
12,新田美波,24,14,38,1.714285714
12,多田李衣菜,23,15,38,1.533333333
14,二宮飛鳥,22,15,37,1.466666667
15,速水奏,17,19,36,0.894736842
16,白坂小梅,14,21,35,0.666666667
16,双葉杏,20,15,35,1.333333333
18,輿水幸子,16,17,33,0.941176471
18,本田未央,19,14,33,1.357142857
18,前川みく,19,14,33,1.357142857
21,森久保乃々,21,11,32,1.909090909
21,島村卯月,18,14,32,1.285714286
21,宮本フレデリカ,16,16,32,1
21,アナスタシア,17,15,32,1.133333333
25,佐藤心,13,16,29,0.8125
26,神崎蘭子,22,6,28,3.666666667
26,橘ありす,12,16,28,0.75
26,三船美優,11,17,28,0.647058824
29,星輝子,16,11,27,1.454545455
29,塩見周子,13,14,27,0.928571429
31,大槻唯,11,14,25,0.785714286
32,諸星きらり,12,12,24,1
33,鷹富士茄子,10,13,23,0.769230769
34,相葉夕美,14,8,22,1.75
34,水本ゆかり,12,10,22,1.2
34,五十嵐響子,12,10,22,1.2
37,小早川紗枝,8,13,21,0.615384615
37,依田芳乃,12,9,21,1.333333333
39,藤原肇,10,10,20,1
39,城ヶ崎美嘉,8,12,20,0.666666667
41,乙倉悠貴,9,10,19,0.9
42,荒木比奈,11,7,18,1.571428571
43,櫻井桃華,10,7,17,1.428571429
43,川島瑞樹,9,8,17,1.125
43,姫川友紀,11,6,17,1.833333333
43,佐々木千枝,9,8,17,1.125
43,三村かな子,9,8,17,1.125
48,関裕美,10,5,15,2
48,赤城みりあ,12,3,15,4
48,喜多見柚,7,8,15,0.875
48,佐城雪美,12,3,15,4
48,上条春菜,11,4,15,2.75
53,日野茜,9,5,14,1.8
53,大石泉,8,6,14,1.333333333
53,堀裕子,6,8,14,0.75
56,結城晴,8,5,13,1.6
56,白菊ほたる,9,4,13,2.25
58,早坂美玲,8,3,11,2.666666667
58,喜多日菜子,7,4,11,1.75
58,今井加奈,7,4,11,1.75
61,道明寺歌鈴,8,2,10,4
61,海老原菜帆,6,4,10,1.5
61,木村夏樹,2,8,10,0.25
61,和久井留美,1,9,10,0.111111111
61,南条光,6,4,10,1.5
66,高峯のあ,5,4,9,1.25
66,並木芽衣子,6,3,9,2
66,ライラ,7,2,9,3.5
69,遊佐こずえ,6,2,8,3
69,脇山珠美,1,7,8,0.142857143
69,的場梨沙,7,1,8,7
69,椎名法子,5,3,8,1.666666667
69,東郷あい,4,4,8,1
69,工藤忍,6,2,8,3
69,中野有香,3,5,8,0.6
76,藤本里奈,3,4,7,0.75
76,菊地真,5,2,7,2.5
76,浜口あやめ,4,3,7,1.333333333
76,小関麗奈,5,2,7,2.5
76,大原みちる,6,1,7,6
76,向井拓海,1,6,7,0.166666667
82,龍崎薫,4,2,6,2
82,片桐早苗,3,3,6,1
82,水木聖來,2,4,6,0.5
82,村上巴,5,1,6,5
82,星井美希,2,4,6,0.5
82,城ヶ崎莉嘉,4,2,6,2
82,及川雫,2,4,6,0.5
82,十時愛梨,5,1,6,5
82,ナターリア,2,4,6,0.5
82,イヴ・サンタクロース,3,3,6,1
92,高槻やよい,2,3,5,0.666666667
92,財前時子,4,1,5,4
92,西園寺琴歌,4,1,5,4
92,池袋晶葉,4,1,5,4
92,松尾千鶴,2,3,5,0.666666667
92,市原仁奈,2,3,5,0.666666667
92,奥山沙織,1,4,5,0.25
92,天海春香,2,3,5,0.666666667
92,四条貴音,2,3,5,0.666666667
92,仙崎恵磨,2,3,5,0.666666667
92,クラリス,3,2,5,1.5
103,萩原雪歩,2,2,4,1
103,棟方愛海,4,0,4,0
103,梅木音葉,4,0,4,0
103,桃井あずき,3,1,4,3
103,有浦柑奈,4,0,4,0
103,日下部若葉,2,2,4,1
103,我那覇響,2,2,4,1
103,八神マキノ,1,3,4,0.333333333
111,黒川千秋,2,1,3,2
111,高橋礼子,1,2,3,0.5
111,藤居朋,1,2,3,0.5
111,綾瀬穂乃香,1,2,3,0.5
111,桐生つかさ,1,2,3,0.5
111,松永涼,1,2,3,0.5
111,松本沙理奈,1,2,3,0.5
111,村松さくら,1,2,3,0.5
111,服部瞳子,1,2,3,0.5
111,斉藤洋子,1,2,3,0.5
111,岡崎泰葉,3,0,3,0
111,如月千早,1,2,3,0.5
111,大沼くるみ,2,1,3,2
111,大和亜季,0,3,3,0
111,三好紗南,3,0,3,0
126,首藤葵,2,0,2,0
126,長富蓮実,2,0,2,0
126,西島櫂,1,1,2,1
126,秋月律子,0,2,2,0
126,矢口美羽,2,0,2,0
126,真鍋いつき,0,2,2,0
126,相川千夏,1,1,2,1
126,浅利七海,2,0,2,0
126,水瀬伊織,2,0,2,0
126,横山千佳,1,1,2,1
126,栗原ネネ,0,2,2,0
126,松山久美子,2,0,2,0
126,成宮由愛,2,0,2,0
126,土屋亜子,2,0,2,0
126,古澤頼子,1,1,2,1
126,原田美世,1,1,2,1
126,兵藤レナ,1,1,2,1
126,丹羽仁美,2,0,2,0
126,三浦あずさ,1,1,2,1
126,メアリー・コクラン,0,2,2,0
146,難波笑美,0,1,1,0
146,若林智香,0,1,1,0
146,福山舞,1,0,1,0
146,相原雪乃,1,0,1,0
146,涼宮星花,1,0,1,0
146,江上椿,1,0,1,0
146,氏家むつみ,0,1,1,0
146,柊志乃,0,1,1,0
146,木場真奈美,1,0,1,0
146,望月聖,0,1,1,0
146,月宮雅,0,1,1,0
146,持田亜里沙,0,1,1,0
146,愛野渚,0,1,1,0
146,安斎都,1,0,1,0
146,吉岡沙紀,1,0,1,0
146,古賀小春,1,0,1,0
146,双海真美,0,1,1,0
146,北川真尋,0,1,1,0
146,冴島清美,1,0,1,0
146,ルーキートレーナー,1,0,1,0
146,ヘレン,0,1,1,0
146,ケイト,0,1,1,0
168,間中美里,0,0,0,0
168,野々村そら,0,0,0,0
168,赤西瑛梨華,0,0,0,0
168,西川保奈美,0,0,0,0
168,衛藤美紗希,0,0,0,0
168,篠原礼,0,0,0,0
168,相馬夏美,0,0,0,0
168,瀬名詩織,0,0,0,0
168,浜川愛結奈,0,0,0,0
168,浅野風香,0,0,0,0
168,沢田麻理菜,0,0,0,0
168,水野翠,0,0,0,0
168,槙原志保,0,0,0,0
168,榊原里美,0,0,0,0
168,楊菲菲,0,0,0,0
168,桐野アヤ,0,0,0,0
168,柳瀬美由紀,0,0,0,0
168,柳清良,0,0,0,0
168,松原早耶,0,0,0,0
168,杉坂海,0,0,0,0
168,岸部彩華,0,0,0,0
168,小松伊吹,0,0,0,0
168,小室千奈美,0,0,0,0
168,太田優,0,0,0,0
168,大西由里子,0,0,0,0
168,双海亜美,0,0,0,0
168,伊集院惠,0,0,0,0
168,井村雪菜,0,0,0,0
168,上田鈴帆,0,0,0,0
168,マスタートレーナー,0,0,0,0
168,ベテラントレーナー,0,0,0,0
168,トレーナー,0,0,0,0
168,キャシー・グラハム,0,0,0,0